40 9
#######################################
#.@...^...........^..............^.¤..#
#.....^..^........^....^.........^.¤..#
#.....^..^........^....^.........^....#
#.....^..^..#.....^....^....g.........#
#.....^..^..#..........^....g.........p
#........^......b......^..............#
#######################################


